.#.................................#............................................................................
................................................................................................................
................................................................................................................
..........V..................VVV................................................................................
..........V...................................................-######...........................................
..........V...................................................-.................................................
..........V...................................................-.................................................
..........V...................................................-.................................................
..........V..................................................##.................................................
..........V..................-#######.......................##..................................................
..........V.......#........................................###..................................................
.................##.....................##................###...................................##..............
1..........O....###.....................##...............####...................................##.............X
#######################....####......###########################################################################
#######################....####......###########################################################################
