................................................................................................................
................................................................................................................
................................................................................................................
................................................................................................................
..............................................................-######...........................................
........................V.......................................................................................
..............................................................-.................................................
................................................................................................................
..............................................................-.................................................
.............................................................##.................................................
.............................:#######.......................##..................................................
..................#........................................###..................................................
.................##.....................##................###...................................##..............
1..........O....###.................OO..##..OOO.......O..####.....................OO....O.O.....##....O.O......X
#######################.########################################################################################
