.#.................................#............................................................................
................................................................................................................
................................................................................................................
..................V.............................................................................................
..........V.......V..........VVV................................................................................
..........V.......V...........................................-######...........................................
..........V.......V...........................................-.................................................
..........V.......V...........................................-.................................................
..........V.......V...........................................-.................................................
..........V.......V..........................................##.................................................
..........V.......V..........:#######.......................##..................................................
..........V.......#........................................###..................................................
..........V......##.....................##................###...................................##..............
1.....L...H..O..###.....................##...............####...................................##.............X
#######################.########################################################################################
