......................................................................................................................................................
......................................................................................................................................................
......................................................................................................................................................
.....................................................................................V................................................................
.....................................................................................................................................................X
.............................................................O.......................................................................................#
...........................................................#######.................................................................................###
.........................................................................................##...........................#...........................####
.....................................................................####...........##.......#......#..............#..##.........................#####
..........................................................#.................#####..................##.............##..###.......................######
............######............##...........##...........###.......................................###..#.........###..###..........####........#######
......................##......##...........##....................#...............................####..##.......####..####..................##########
.1........J..O.........##..O...##......L....##...............H....#.............O...O..O..O......#####..###.....#####..#####.......O..O......#########
#################################################...##############........##########################################..################################
#################################################...##############........##########################################..################################