.....................................#..................................................................#....................
.....................................#..................................................................#....................
.....................................#..................................................................#....................
.....................................#.................#######################..........................#....................
....V............V...................#................#.................................................#....................
......................#....L.........#..............###............O...O................................#....................
......................##########.....#.............####..........#################################......#....................
......................#..............#...........O#####.................................................#....................
....................##...............#........#########...............................................L.#....................
................--..........#...L....#.......##########.......O...........###############################....................
............................##########......###########......####............................................................
................##.........................############...........................##.........................................
1..........O...#.......#.....L............#############......H.....#..............##H........#......................X........
######..#####..........######################################################################################################
######..#####..........######################################################################################################
