......................
...G............X.....
...--..G.......--.....
....G.--........G.....
...--..........--.....
...G......G....G......
...--....--....--.....
....G...........G.....
...--........G.--.....
...G........--.G......
...--..........--.....
....G...........G...GG
#..--..........--.....
1..........L..HHH.....
######################
