..V...V...V...V...V...V...V.......V.......V.......V.......V.......V.......V.......V......V...................................
...............................................................#.............................................................
...............................................................#.............................................................
....................................#..............#...........#.............................################################
..............................H....###....H.......###..........#............................................................#
......................##################################.......#............................................................#
.............##....#..#........................................#..................................J.........................#
......................#........................................#......................#..################...................#
........##............#.............L........O........L........#..................#.....................#.............J....X#
......................#........#################################...............#........................#####################
.....##.....##........#.......#............................................#................................................#
.................##....................................................#.......................#............................#
.1.........O...................L....###..........L................L............................#............................#
#################################.........#############################.####.######.######.#####.............................
