......................
...G............X.....
...--..G.......--.....
....G.--........G.....
...--..........--.....
...GC.....G....G......
...--....--....--.....
....G...........G.....
...--........G.--.....
...G........--.G......
...--..........--.....
....G...........G...GG
#..--..........--.....
1..........C........CC
######################
