.......................................................
......G.....A........G...............................X.
#--#########################################....#######
.......######..................................#.......
..G..............G............................#........
####..G.G.G.G....###.........................#.........
.......G.GAG.G..............................#..........
......--------.............................#...........
...--...........--........................#............
.........................................#.............
.G.G............G.G.....................#..............
####.........#..####................#..#...............
............##........................#................
..1........###.......A...............#.................
#######################################################