#...............................................................................................................
................................................................................................................
................................................................................................................
################################################################################################################
..........V..................VVV................................................................................
..........V...................................................-######...........................................
..........V...................................................-.................................................
..........V...................................................-.................................................
.................................L...........................##.................................................
.............................-#######.......................##..................................................
..................#........................................###..................................................
........................................##................###...................................##..............
1.........H........#.X.......L....H.....##.......L.......####...................................##..............
################################################################################################################
.#########.############....####......###########################################################################
