................................................................................................................
................................................................................................................
................................................................................................................
.............................VVV................................................................................
..............................................................-######...........................................
................................................................................................................
..............................................................-.................................................
................................................................................................................
..........V...................................................-.................................................
.............................................................##.................................................
.............................:#######.......................##..................................................
..................#........................................###..................................................
.................##.....................##................###...................................##..............
1.....L...H..O..###.....................##...............####...................................##.............X
#######################.########################################################################################
