.......................................................................................................
.......................................................................................................
.......................................................................................................
.......######..........................................................................................
..G..............G.....................................................................................
####..G.G.G.G....###...................................................................................
.......G.G.GHG.........................................................................................
......--------.........................................................................................
...--...........--.....................................................................................
.......................................................................................................
.G.G............H.H....................................................................................
####............####.....................#####.........................................................
.......................................................................................................
1..........H................H...................................H..................................X...
#######################################################################################################
